NO sprites/brick128.xpm
SO sprites/whbrick128.xpm
WE sprites/door128.xpm
EA sprites/interior128.xpm

F 236,204,162
C 135,206,235

    111111111111111111111111111111111111111111
    1W000000000111000000000001111110000000001
    100000000000111000000000001111110000000001
    100000000000111000000000001111110000000001
    111110011111111111011000111111111100011111
    100000010000000011011000111111111000000001
    100000010000000011011000111111111000000001
    100000010000000011011101111111111000000001
1111101111111101111101110111111111101111111111
11000000000011111001100000000000011111111
11001110011011111101100000000000011111111
10000100001000000001100011000000011111111
1000010000100000001100000000000011111111
1000111000100000000110000000000001111
1000111000100000000110000000000001111
1000000000100000000000000000000001111
1111111111111111111111111111111111111
