NO sprites/brick128.xpm
SO sprites/whbrick128.xpm
WE sprites/door128.xpm
EA sprites/interior128.xpm

F 128,0,32
C 135,206,235

1111111
1110W01
1100001
1111111

